|5 10
|--------|
|...|..-.|
|..-|.@..|
|......-.|
|--------|